###############
#..o.....o..S.#
#..#...#...#..#
#o............#
#..##....##...#
#.............#
##............#
#.............#
#..##.........#
#.......o.....#
#..o..####....#
#o.F.E.F......#
###############
