###############
#S.........E..#
#.............#
#.......#.#o..#
#......o..FFoo#
#o....#o.#FFFF#
#F.....o......#
##..#.Fo......#
#......Fo.....#
###....FFF....#
#.....####....#
#....oooooo...#
###############
